NO ./path_to_the_north_texture.xpm
SO ./path_to_the_south_texture.xpm
WE ./path_to_the_west_texture.xpm
EA ./path_to_the_east_texture.xpm
S ./textures/creeper.xpm
F 220,100,0
C 77,77,77

1111111111111111111111111
1000000000110000000000001
1011000001110000002000001
1001000000000000000002001
11111111101100000111000001111111
1000000000110000011101111111111
11110111111111011100000010001
11110111111111011101010010001
11000000110101011100000010001
10002000000000001100000010001
10000000000000001101010010001
11000001110101011111011110N111
111101111110101101111010001
111111111111111111111111111